Aso.	Tio.
Apo.	Apo.
Apo.	Apo.
Noo.	Dai.
Abo.	Abo.
Ako.	Ako.
Ama.	Ama.
Ang.	Ang.
Ano.	Ano.
Apo.	Apo.
Aso.	Aso.
Ehe.	Ihi.
Iba.	Iba.
Ina.	Ina.
Ipa.	Opa.
Iyo.	Imo.
Tae.	Tae.
Tao.	Tao.
Ubi.	Ubi.
Uod.	Uod.
Uwi.	Uwi.
Uwak.	Wak.
Saan?   Sadin?
Paa.	Siki.
Halo.	Alo.
Hari.	Adi.
Hito.	Ito.
Hiya.	Eya.
Huli.	Ori.
Huni.	Oni.
Look.	Lek.
Luha.	Loa.
Saha.	Saa.
Ubo.	Uboh.
Ulo.	Uloh.
Usa.	Usah.
Uso.	Usoh.
Baha.	Ba.
Gabi.	Gabi.
Piga.	Pega.
Pusa.	Koti.
Baka.	Baka.
Pato.	Pato.
Isda.	Isda.
Anay.	Anay.
Atis.	Atis.
Suha.	Soha.
Ubas.	Obas.
Toge.	Togi.
Ama.	Tatay.
Ina.	Nanay.
Bata.	Bata.
Lolo.	Lolo.
Lola.	Lola.
Buhok.	Bok.
Mata.	Mata.
Dila.	Dila.
Leeg.	Lieg.
Siko.	Siko.
Tuhod.	Tod.
Kuko.	Koko.
Apdo.	Apdo.
Dugo.	Dogo.
Utak.	Otok.
Atay.	Atay.
Baga.	Baga.
Ugat.	Ogat.
Buli.	Boli.
Abot.	Abot.
Akin.	Aken.
Agaw.	Agaw.
Alon.	Alen.
Amin.	Amen.
Anay.	Anay.
Anim.	Anem.
Anod.	Anod.
Apat.	Apat.
Apdo.	Apdo.
Apog.	Apog.
Aral.	Adal.
Arko.	Arko.
Asin.	Asin.
Atay.	Atay.
Atin.	Aten.
Atip.	Atep.
Atis.	Atis.
Awat.	Awat.
Baka.	Baka.
Balo.	Balo.
Bara.	Bara.
Basa.	Basa.
Baso.	Baso.
Bata.	Bata.
Bato.	Bato.
Baul.	Baul.
Bayo.	Bayo.
Belo.	Bilo.
Biko.	Biko.
Bota.	Bota.
Boto.	Boto.
Bubo.	Bobo.
Buko.	Boko.
Bula.	Bora.
Buyu.	Boyo.
Kain.	Kaen.
Kama.	Kama.
Kami.	Kami.
Kape.	Kapi.
Kawa.	Kawa.
Kayo.	Kamo.
Keso.	Kiso.
Krus.	Kros.
Kuko.	Koko.
Kura.	Kora.
Kuta.	Kota.
Daan.	Daan.
Daig.	Daeg.
Dala.	Dara.
Dali.	Dali.
Dati.	Dati.
Dama.	Dama.
Dapa.	Dapa.
Daya.	Daye.
Dila.	Dila.
Dipa.	Depa.
Duda.	Doda.
Dugo.	Dogo.
Dura.	Dora.
Edad.	Idad.
Gaan.	Agan.
Gaas.	Gaas.
Gabi.	Gabi.
Gana.	Gana.
Gata.	Gata.
Giba.	Geba.
Giik.	Gyek.
Giya.	Giya.
Gulo.	Golo.
Ikaw.	Ikaw.
Ihip.	Eyep.
Init.	Init.
Inom.	Inem.
Inyo.	Indo.
Ipit.	Ipit.
Isa.	Isara.
Isda.	Isda.
Isip.	Isip.
Laso.	Laso.
Lata.	Lata.
Layo.	Raye.
Leeg.	Lieg.
Libo.	Ribo.
Liko.	Kilo.
Liha.	Liha.
Lila.	Lila.
Lima.	Lima.
Lisa.	Lesa.
Losa.	Losa.
Lugi.	Logi.
Luno.	Lono.
Luya.	Loya.
Mais.	Mais.
Mani.	Mani.
Mapa.	Mapa.
Masa.	Masa.
Mata.	Mata.
Maya.	Maya.
Mayo.	Mayo.
Mina.	Mina.
Misa.	Misa.
Moda.	Moda.
Mumo.	Momo.
Nana.	Nana.
Okra.	Okra.
Oras.	Oras.
Pagi.	Pagi.
Paha.	Paha.
Pait.	Pait.
Pala.	Pala.
Palo.	Palo.
Pana.	Pana.
Papa.	Papa.
Para.	Para.
Pari.	Padi.
Paos.	Paos.
Pasa.	Pasa.
Paso.	Paso.
Pati.	Pati.
Pato.	Pato.
Pero.	Piro.
Piko.	Piko.
Piko.	Tiko.
Piga.	Pega.
Pili.	Pili.
Pino.	Pino.
Piso.	Piso.
Pito.	Pito.
Piye.	Piyi.
Puga.	Poga.
Pugo.	Pogo.
Pula.	Pola.
Pulo.	Poro.
Puno.	Pono.
Puro.	Poro.
Puso.	Poso.
Puta.	Pota.
Puti.	Poti.
Puto.	Poto.
Ripa.	Ripa.
Rota.	Rota.
Saba.	Saba.
Sako.	Sako.
Sala.	Sala.
Sala.	Sara.
Sapa.	Sapa.
Saya.	Saya.
Sebo.	Sibo.
Siko.	Siko.
Sige.	Sigi.
Sine.	Sini.
Sino.	Sino.
Sipa.	Sipa.
Suki.	Suki.
Sugo.	Sugo.
Suha.	Suha.
Sulo.	Sulo.
Suot.	Suot.
Taal.	Taal.
Taas.	Taas.
Taga.	Taga.
Tama.	Tama.
Tari.	Tari.
Tasa.	Tasa.
Tela.	Tela.
Tono.	Tono.
Tore.	Tore.
Toyo.	Toyo.
Trak.	Trak.
Tren.	Tren.
Tsaa.	Tsaa.
Tubo.	Tubo.
Tubo.	Tubo.
Tubo.	Tubo.
Tuka.	Tuka.
Tuli.	Tuli.
Tulo.	Tulo.
Tuod.	Tuod.
Turo.	Turo.
Ubas.	Ubas.
Uban.	Uban.
Ubod.	Ubod.
Ubos.	Ubos.
Ugat.	Ugat.
Uhah.	Uhaw.
Uhag.	Uhay.
Ulan.	Ulan.
Unat.	Unat.
Utak.	Utak.
Uwak.	Uwak.
Araw.	Adlaw.
Halik.	Arek.
Sisiw.	Pise.
Unggoy.	Amo.
Pana.	Logay.
Kahil.	Kail.
Mukha.	Oyen.
Bibig.	Baba.
Labi.	Bibig.
Tiyan.	Tian.
Buto.	Tolan.
Laman.	Onod.
Bato.	Kidni.
Araw.	Adlaw.
Asim.	Aslem.
Baon.	Balon.
Bihag.	Biag.
Biik.	Beyek.
Binhi.	Bini.
Buhok.	Book.
Kahoy.	Kaoy.
Kayas.	Kias.
Kupas.	Kopa.
Dahon.	Daon.
Diyos.	Dios.
Diyan.	Dian.
Gubat.	Geba.
Hakot.	Akot.
Halik.	Arek.
Halos.	Alos.
Hapdi.	Apdi.
Hapon.	Apon.
Hatid.	Ated.
Hayop.	Ayep.
Higa.	Ingga.
Higop.	Igep.
Hilaw.	Ilaw.
Himas.	Imas.
Hindi.	Indi.
Hipag.	Ipag.
Hubad.	Obad.
Hukom.	Okon.
Hugas.	Ogas.
Hugot.	Ogot.
Hulog.	Olog.
Luhod.	Lood.
Mahal.	Maal.
Ngiwi.	Kiwi.
Pahid.	Paid.
Pawid.	Paod.
Relo.	Rilos.
Sala.	Salas.
Uling.	Ulig.
Utang.	Utag.
Walo.	Waloh.
Wili.	Wilih.
Yelo.	Yeloh.
Yero.	Yeroh.
Yoyo.	Yoyoh.
Ulan.	Oran.
Ngayon.	Dadi.
Maaga.	Maaga.
Pera.	Koarta.
Gilid.	Kilid.
Tawag.	Tawag.
Umupo.	Paggurang.
Ibon.	Ibon.
Manok.	Manok.
Baboy.	Baboy.
Ahas.	Magkal.
Tigre.	Tigri.
Kasoy.	Kasoy.
Piras.	Piras.
Pinya.	Pinya.
Karot.	Karot.
Sitaw.	Sitaw.
Tiyo.	Tiohin.
Tiya.	Tiahin.
Bayaw.	Bayaw.
Hipag.	Hipag.
Pinsan.	Ilog.
Bungo.	Bongo.
Ilong.	Irong.
Ngipin.	Ipen.
Kamay.	Alima.
Tiyan.	Posod.
Pulso.	Polso.
Balat.	Kolit.
Abril.	Abril.
Album.	Albom.
Ampon.	Ampon.
Anino.	Anino.
Araro.	Arado.
Armas.	Armas.
Asawa.	Asawa.
Asero.	Asiro.
Asoge.	Asogi.
Atras.	Atras.
Ayuda.	Ayoda.
Babae.	Babai.
Babaw.	Babaw.
Baboy.	Baboy.
Bakla.	Bakla.
Bakya.	Bakya.
Balsa.	Balsa.
Balse.	Balsi.
Banda.	Banda.
Banig.	Banig.
Banga.	Banga.
Banyo.	Banyo.
Bapor.	Bapor.
Barko.	Barko.
Basyo.	Basyo.
Batya.	Batya.
Bawal.	Bawal.
Bayad.	Bayad.
Bayas.	Bayas.
Bayaw.	Bayaw.
Benda.	Binda.
Berde.	Birdi.
Berso.	Birso.
Bezes.	Bisis.
Bigas.	Begas.
Bigat.	Begat.
Bihon.	Bihon.
Bilas.	Bilas.
Lipad.	Lepad.
Lipas.	Lebas.
Lista.	Lista.
Litaw.	Lotaw.
Lugar.	Logar.
Luksa.	Loksa.
Lugaw.	Logaw.
Lumot.	Lomot.
Lunes.	Lonis.
Maaga.	Maaga.
Madre.	Madri.
Mamon.	Mamon.
Manok.	Manok.
Marso.	Marso.
Metro.	Mitro.
Muhon.	Mohon.
Multa.	Molta.
Nanay.	Nanay.
Niyog.	Niyog.
Ngalan.	Aran.
Ngilo.	Ngilo.
Ngipin.	Ipin.
Pader.	Padir.
Palay.	Paray.
Palya.	Palya.
Panga.	Panga.
Panyo.	Panyo.
Papel.	Papil.
Pasan.	Pasan.
Pasko.	Pasko.
Patag.	Patag.
Patay.	Patay.
Patis.	Patis.
Pekas.	Pikas.
Petsa.	Pitsa.
Pikot.	Pikot.
Pigsa.	Pegsa.
Pihit.	Pirit.
Pinya.	Pinya.
Pirma.	Pirma.
Pisip.	Pisil.
Pison.	Pison.
Pista.	Pista.
Pitso.	Pitso.
Piyon.	Piyon.
Plaka.	Plaka.
Plano.	Plano.
Plasa.	Plasa.
Plema.	Plima.
Poder.	Poder.
Pondo.	Pundu.
Prito.	Prito.
Pugad.	Pogad.
Pugto.	Bogto.
Pulis.	Polis.
Pulso.	Polso.
Punas.	Ponas.
Purok.	Porok.
Pusod.	Posod.
Puson.	Poson.
Pusta.	Posta.
Putol.	Potol.
Radyo.	Radyo.
Raspa.	Raspa.
Regla.	Rigla.
Renda.	Rinda.
Reyna.	Rayna.
Ribon.	Ribon.
Rimas.	Rimas.
Ronda.	Ronda.
Rosas.	Rosas.
Sabaw.	Sabaw.
Sabog.	Sabog.
Sabon.	Sabon.
Sakay.	Sakay.
Sakit.	Sakit.
Sakop.	Sakop.
Sahig.	Saleg.
Salok.	Sarok.
Salot.	Sarot.
Salsa.	Sarsa.
Sanga.	Sanga.
Selyo.	Silyo.
Silaw.	Solaw.
Silbi.	Sirbi.
Silid.	Seled.
Silya.	Silya.
Sindi.	Sindi.
Singa.	Senga.
Siper.	Siper.
Sipon.	Sipon.
Sitaw.	Sitaw.
Sobre.	Sobre.
Sopas.	Sopas.
Sugal.	Sugal.
Suhay.	Suhay.
Sulat.	Sulat.
Sulsi.	Sulsi.
Suman.	Suman.
Sumpa.	Sumpa.
Sunog.	Sunog.
Lipad.	Lepad.
Lipas.	Lebas.
Lista.	Lista.
Litaw.	Lotaw.
Lugar.	Logar.
Luksa.	Loksa.
Lugaw.	Logaw.
Lumot.	Lomot.
Lunes.	Lonis.
Maaga.	Maaga.
Madre.	Madri.
Mamon.	Mamon.
Manok.	Manok.
Marso.	Marso.
Metro.	Mitro.
Muhon.	Mohon.
Multa.	Molta.
Nanay.	Nanay.
Niyog.	Niyog.
Ngalan.	Aran.
Ngilo.	Ngilo.
Ngipin.	Ipin.
Pader.	Padir.
Palay.	Paray.
Palya.	Palya.
Panga.	Panga.
Panyo.	Panyo.
Papel.	Papil.
Pasan.	Pasan.
Pasko.	Pasko.
Patag.	Patag.
Patay.	Patay.
Patis.	Patis.
Pekas.	Pikas.
Petsa.	Pitsa.
Pikot.	Pikot.
Pigsa.	Pegsa.
Pihit.	Pirit.
Pinya.	Pinya.
Pirna.	Pirna.
Pisip.	Pisil.
Pison.	Pison.
Pista.	Pista.
Pitso.	Pitso.
Piyon.	Piyon.
Plaka.	Plaka.
Plano.	Plano.
Plasa.	Plasa.
Plema.	Plima.
Poder.	Poder.
Pondo.	Pundu.
Prito.	Prito.
Pugad.	Pogad.
Pugto.	Bogto.
Pulis.	Polis.
Pulso.	Polso.
Punas.	Ponas.
Purok.	Porok.
Pusod.	Posod.
Puson.	Poson.
Pusta.	Posta.
Putol.	Potol.
Radyo.	Radyo.
Raspa.	Raspa.
Regla.	Rigla.
Renda.	Rinda.
Reyna.	Rayna.
Ribon.	Ribon.
Rimas.	Rimas.
Ronda.	Ronda.
Rosas.	Rosas.
Sabaw.	Sabaw.
Sabog.	Sabog.
Sabon.	Sabon.
Sakay.	Sakay.
Sakit.	Sakit.
Sakop.	Sakop.
Sahig.	Salig.
Salok.	Sarok.
Salot.	Sarot.
Salsa.	Sarsa.
Sanga.	Sanga.
Selyo.	Silyo.
Silaw.	Solaw.
Silbi.	Sirbi.
Silid.	Seled.
Silya.	Silya.
Sindi.	Sindi.
Singa.	Senga.
Siper.	Siper.
Sipon.	Sipon.
Sitaw.	Sitaw.
Sobre.	Sobre.
Sopas.	Sopas.
Sugal.	Sugal.
Suhay.	Suhay.
Sulat.	Sulat.
Sulsi.	Sulsi.
Suman.	Suman.
Sumpa.	Sumpa.
Sunog.	Sunog.
Supot.	Supot.
Surot.	Surot.
Tabla.	Tabla.
Tabas.	Tabas.
Tabon.	Tabon.
Tahip.	Tahip.
Talim.	Talim.
Tamad.	Tamad.
Tamis.	Tamis.
Tanan.	Tanan.
Tanda.	Tanda.
Tanga.	Tanga.
Tanim.	Tanim.
Tanso.	Tanso.
Tapos.	Tapos.
Tatay.	Tatay.
Tawad.	Tawad.
Tawag.	Tawag.
Tawas.	Tawas.
Tenis.	Tenis.
Tibag.	Tibag.
Tibay.	Tibay.
Tiket.	Tiket.
Tigas.	Tigas.
Tigib.	Tigib.
Tigre.	Tigre.
Timog.	Timog.
Tinda.	Tinda.
Tingi.	Tingi.
Tinik.	Tinik.
Tinta.	Tinta.
Tises.	Tises.
Tinta.	Tinta.
Tisis.	Tisis.
Tiyan.	Tiyan.
Trono.	Trono.
Tropa.	Tropa.
Troso.	Troso.
Tsart.	Tsart.
Tsiko.	Tsiko.
Tubig.	Tubig.
Tukod.	Tukod.
Tukso.	Tukso.
Tuhod.	Tuhod.
Tuhog.	Tuhog.
Tulad.	Tulad.
Tulay.	Tulay.
Tulda.	Tulda.
Tumba.	Tumba.
Tunaw.	Tunaw.
Tunog.	Tunog.
Tusok.	Tusok.
Tuwad.	Tuwad.
Ugali.	Ugali.
Usisa.	Usisa.
Wisik.	Wisik.
Yapak.	Yapak.
Mayo.	Mayo.
Araw.	Adlaw.
Lupa.	Logta.
Niyebe.	Yilo.
Sumayaw.	Saot.
Itulak.	Tolod.
Niyog.	Beteng.
Labong.	Tambo.
Gilagid.	Lasi.
Braso.	Betken.
Dibdib.	Iteng.
Dibdib.	Degan.
Daliri.	Todlo.
Katawan.	Awak.
Bituka.	Tinai.
Mabuti.	Mayad.
Mabait.	Mayad.
Tanga.	Polpol.
Isara.	Sirado.
Itulak.	Tolod.
Adiyos.	Adios.
Amihan.	Amian.
Anghit.	Angit.
Buugaw.	Bogaw.
Buhawi.	Boawi.
Bunggo.	Bongo.
Buwaya.	Boaya.
Kidlat.	Kilat.
Dalawa.	Darwa.
Espiya.	Ispia.
Hagdan.	Agdan.
Halang.	Arang.
Haligi.	Arigi.
Hambog.	Ambog.
Hangin.	Angin.
Haplos.	Apros.
Harana.	Arana.
Harina.	Arina.
Hasang.	Asang.
Lansa.	Langsa.
Lilim.	Ilemem.
Mabaho.	Mabao.
Mantsa.	Mansa.
Nahiya.	Naeva.
Nahuli.	Naori.
Perlas.	Piras.
Punso.	Pongso.
Rantso.	Ranso.
Santo.	Santos.
Unano.	Unanoh.
Welga.	Welgah.
Yabong.	Yabog.
Abril.	Abril.
Buwan.	Bolan.
Bagyo.	Bagyo.
Buhawi.	Boawi.
Hangin.	Angin.
Bukas.	Aromang.
Maalat.	Maasin.
Palakpak.	Daep.
Tumalon.	Lobo.
Humila.	Beteng.
Tindig.	Tindeg.
Lumangoy.	Eseb.
Bokbok.	Bokbok.
Kalapati.	Lade.
Kabayo.	Kabayo.
Dorian.	Dorian.
Lomboy.	Lomboy.
Langka.	Langka.
Pakwan.	Pakwan.
Saging.	Saging.
Pipino.	Pipino.
Talong.	Tarong.
Bawang.	Lasona.
Pechay.	Pitsay.
Ninong.	Ninong.
Ninang.	Ninang.
Bigote.	Bigoti.
Balbas.	Benget.
Balikat.	Abaga.
Pantog.	Pantog.
Maganda.	Goapa.
Gwapo.	Goapo.
Tamad.	Tamadan.
Mataas.	Mataas.
Agosto.	Agosto.
Ahente.	Ahintai.
Alahas.	Alahas.
Alalay.	Alalay.
Angkin.	Angken.
Anonas.	Anonas.
Asenso.	Asinso.
Asukal.	Asukar.
Asunto.	Asonto.
Atsara.	Atsara.
Bakuna.	Bakona.
Balita.	Barita.
Balota.	Balota.
Banak.	Balanak.
Bangko.	Bangko.
Banlag.	Banlag.
Banlaw.	Bonlaw.
Bantay.	Bantay.
Bantog.	Bantog.
Baraha.	Baraha.
Barnis.	Barnis.
Basket.	Baskit.
Baston.	Baston.
Batuta.	Batuta.
Bayong.	Bayong.
Besbol.	Bisbol.
Bigkis.	Begkes.
Bihira.	Bihira.
Bilang.	Bilang.
Biling.	Biring.
Binlid.	Binled.
Binyag.	Bonyag.
Birhen.	Birhin.
Bukana.	Bokana.
Bukayo.	Bokayo.
Bukbok.	Bokbok.
Butete.	Botiti.
Kabayo.	Kabayo.
Kadena.	Kadina.
Kadyos.	Kadyes.
Kagabi.	Kagabi.
Kahera.	Kahira.
Kainan.	Kaenan.
Kamias.	Kamias.
Kangina.	Kaina.
Kapote.	Kapoti.
Karera.	Karira.
Kasalo.	Kasaro.
Katalo.	Katalo.
Kilala.	Kilala.
Kingke.	Kingki.
Kisame.	Kisami.
Korona.	Korona.
Krisis.	Krisis.
Kristo.	Kristo.
Kulang.	Korang.
Kulata.	Kolata.
Kulong.	Kolong.
Kumpil.	Kompi.
Kumpit.	Kompit.
Kurdon.	Kordon.
Kuskos.	Koskos.
Kusina.	Kosina.
Dalaga.	Daraga.
Daldal.	Daldal.
Daplis.	Daplis.
Dayami.	Dagami.
Domino.	Domino.
Doktor.	Doktor.
Embudo.	Imbodo.
Ensayo.	Insayo.
Epekto.	Ipikto.
Espada.	Ispada.
Esposa.	Isposa.
Esposo.	Isposo.
Estapa.	Istapa.
Galang.	Galang.
Gansal.	Gansal.
Garahe.	Garahi.
Gastos.	Gastos.
Giling.	Giling.
Ginisa.	Ginisa.
Gitara.	Gitara.
Gulong.	Golong.
Guwang.	Gawang.
Ibabaw.	Ibabaw.
Ilalim.	Idalem.
Itsura.	Itsora.
Lababo.	Lababo.
Labaha.	Labaha.
Lagari.	Lagadi.
Lagpak.	Lagpak.
Lalaki.	Lalaki.
Langaw.	Langaw.
Langka.	Langka.
Langit.	Langit.
Libing.	Lebeng.
Litson.	Litson.
Lusong.	Losong.
Maanta.	Maanta.
Maayos.	Maayos.
Mababa.	Mababa.
Makina.	Makina.
Madali.	Madili.
Magaan.	Maagan.
Magama.	Magama.
Magina.	Magina.
Malayo.	Maraye.
Maleta.	Malita.
Mantel.	Mantil.
Mapait.	Mapait.
Marmol.	Marmol.
Martes.	Martis.
Martsa.	Martsa.
Mataas.	Mataas.
Matris.	Matris.
Medyas.	Midyas.
Milyon.	Milyon.
Mintis.	Mintis.
Miting.	Miting.
Minuto.	Minoto.
Musiko.	Mosiko.
Nakikita.	Nakita.
Naipit.	Naipit.
Naisip.	Naisip.
Nalugi.	Nalogi.
Nilaga.	Linaga.
Niloko.	Inloko.
Ninang.	Ninang.
Ninong.	Ninong.
Nganga.	Nganga.
Obrero.	Obriro.
Obispo.	Obispo.
Pabaya.	Pabaya.
Pakpak.	Pakpak.
Paksiw.	Paksio.
Palara.	Palara.
Palito.	Palito.
Paltik.	Paltik.
Pandake.	Pandake.
Pansit.	Pansit.
Parada.	Parada.
Pareho.	Pariho.
Parola.	Parola.
Pastol.	Pastor.
Pasyal.	Pasyar.
Patani.	Patani.
Patron.	Patron.
Payong.	Payong.
Pedido.	Pedido.
Petsay.	Pitsay.
Piknik.	Piknik.
Piliin.	Pilien.
Pingga.	Pingga.
Piraso.	Pidaso.
Piring.	Pereng.
Pisngi.	Pisngi.
Pitaka.	Pitaka.
Pitada.	Pitada.
Pitsel.	Pitsil.
Pormal.	Pormal.
Prasko.	Prasko.
Premyo.	Primyo.
Pudpud.	Podpod.
Pulbos.	Polbos.
Pulido.	Polido.
Pulpol.	Polpol.
Puntos.	Pontos.
Putahe.	Potahi.
Rasyon.	Rasyon.
Rayuma.	Riyoma.
Rekado.	Rikado.
Regalo.	Rigalo.
Reseta.	Risita.
Retaso.	Ritaso.
Retiro.	Ritiro.
Ropero.	Ropiro.
Roskas.	Roskas.
Sabado.	Sabado.
Saksak.	Saksak.
Saging.	Saging.
Salpok.	Sampok.
Sangag.	Sanlag.
Sarili.	Sadili.
Sastre.	Sastri.
Sawali.	Sawali.
Sawsaw.	Sawsaw.
Sayang.	Sayang.
Senado.	Sinado.
Sermon.	Sirmon.
Siksik.	Seksek.
Signos.	Signos.
Sima.	Simbahan.
Singaw.	Songaw.
Singko.	Singko.
Sinsin.	Sensen.
Sipsip.	Sipsip.
Sirena.	Sirena.
Subsob.	Subsob.
Suksok.	Suksok.
Sulong.	Sulong.
Sulyap.	Sulyap.
Sungay.	Sungay.
Sungka.	Sungka.
Suntok.	Suntok.
Suriso.	Suriso.
Tabako.	Tabako.
Tabang.	Tabang.
Taklob.	Taaleb.
Tadtad.	Tadtad.
Tainga.	Tainga.
Talaba.	Talaba.
Talaga.	Talaga.
Talong.	Tarong.
Tambol.	Tambol.
Tangke.	Tangke.
Tastas.	Tastas.
Tigpas.	Tigpas.
Tihaya.	Tihaya.
Tinapa.	Tinapa.
Tindig.	Tindig.
Titulo.	Titulo.
Tiyani.	Tiyani.
Tosino.	Tosino.
Tubero.	Tubero.
Tuktok.	Tuktok.
Tugtog.	Tugtog.
Tutuli.	Tutuli.
Uhales.	Uhales.
Unahan.	Unahan.
Utouto.	Utuuto.
Wakwak.	Wakwak.
Yugyog.	Yugyog.
Lunes.	Lonis.
Enero.	Iniro.
Marso.	Marso.
Hunyo.	Honio.
Hulyo.	Holio.
Bituin.	Biton.
Hangin.	Angin.
Lindol.	Linog.
Kidlat.	Kilat.
Ambon.	Tariti.
Talaga.	Matod.
Kahapon.	Kaapon.
Maasim.	Maapled.
Upo.	Barantiong.
Tsikpi.	Monggos.
Patola.	Singkoa.
Tainga.	Talinga.
Puso.	Tagiposon.
Mabait.	Maleban.
Mahaba.	Malabeg.
Maikli.	Mataged.
Atsuete.	Siwiti.
Baliena.	Balina.
Bibliya.	Biblia.
Bulkan.	Bolkano.
Kahapon.	Kaapon.
Kuyumad.	Kaymad.
Dahilan.	Dailan.
Dalahin.	Daraen.
Habagat.	Abagat.
Higante.	Iganti.
Hulmahan.	Orman.
Maasim.	Maaslen.
Hanulog.	Naolog.
Numiroh.	Nomiro.
Paligo.	Parigos.
Pandan.	Pangdan.
Patatas.	Pataas.
Petro.	Pitrolio.
Plantsa.	Plansa.
Salaan.	Sararan.
Sinangag.	Sanag.
Singhot.	Singot.
Ulap.	Panganod.
Tagtuyot.	Mara.
Isa.	Isara
Isa.	ono.
Sa gabi.	Sa gabi.
Diritso.	Diritso.
Kaibigan.	Tangay.
Kambing.	Kambing.
Kalabaw.	Karabaw.
Abokado.	Abokado.
Kaimito.	Kaimito.
Kamatis.	Kamatis.
Mangga.	Pomangga.
Repolyo.	Ripolio.
Mustasa.	Mostasa.
Sibuyas.	Siboyas.
Sentido.	Sintido.
Lalamunan.	Tebeg.
Kilikili.	Jreken.
Kandungan.	Sabak.
Binti.	Ita.
Maingat.	Maandam.
Masipag.	Maderep.
Maganda.	Matinlo.
Bastos.	Maraskal.
Abokado.	Abokado.
Abogado.	Abogado.
Alakdan.	Alakran.
Alambre.	Alambri.
Almirol.	Armidol.
Andamyo.	Andamio.
Artista.	Artista.
Asikaso.	Asikaso.
Aspalto.	Ispalto.
Bakante.	Bakanti.
Balutan.	Balotan.
Bandana.	Bandana.
Bandeha.	Bandiha.
Bandila.	Bandira.
Barbero.	Barsiro.
Bariles.	Barilis.
Baterya.	Batiria.
Bayabas.	Bayabas.
Bayawak.	Bayawak.
Binatog.	Binatog.
Bintana.	Bintana.
Botante.	Botanti.
Bugtong.	Bogtong.
Bulador.	Bolador.
Bumbero.	Bombiro.
Butones.	Botinis.
Buwenas.	Bowinas.
Kaingin.	Kaingin.
Kamalig.	Kamalig.
Kamatis.	Kamatis.
Kambing.	Kambing.
Kamison.	Kamison.
Kampana.	Kampana.
Kandado.	Kandado.
Kandila.	Kandila.
Kantero.	Kantiro.
Kapatas.	Kapatas.
Kastila.	Kastila.
Kawayan.	Kawayan.
Klinika.	Kliniki.
Kolitis.	Kolitis.
Kulugo.	Kalonggo.
Kumusta.	Komosta.
Kunsumo.	Konsomo.
Kurbata.	Korbata.
Kurtina.	Kortina.
Kutsara.	Kotsara.
Kuwarta.	Kowarta.
Kuwarto.	Kowarto.
Kuwelyo.	Kowilio.
Kuwenta.	Kowinta.
Kuwitis.	Kowitis.
Demanda.	Dimanda.
Drayber.	Draiber.
Duwende.	Dowindi.
Eksakto.	Igsakto.
Embargo.	Imbargo.
Empatso.	Impatso.
Esperma.	Ispirma.
Estante.	Istanti.
Gaspang.	Gaspang.
Gunting.	Gonting.
Halakhak.	Alakak.
Higaan.	Iringgan.
Huwebes.	Howibis.
Iladlad.	Iladlad.
Insulto.	Insolto.
Intindi.	Intindi.
Labanos.	Rabanos.
Larawan.	Ladawan.
Mababaw.	Mababaw.
Mabigat.	Mabegat.
Madilim.	Madelem.
Maestra.	Maistra.
Maestro.	Maistro.
Malamig.	Maramig.
Mangkok.	Mangkok.
Mangga.	Pomangga.
Manipis.	Manipis.
Mantika.	Mantika.
Marupok.	Matopok.
Masakit.	Masakit.
Maskada.	Maskada.
Maskara.	Maskara.
Masyado.	Masyado.
Matabil.	Matabil.
Matamis.	Matamis.
Matigas.	Mategas.
Medalya.	Midalya.
Mistisa.	Mistisa.
Mustasa.	Mostasa.
Okyubre.	Oktobri.
Opisina.	Opisina.
Orasyon.	Orasion.
Oregano.	Origano.
Ospital.	Ospital.
Pabigat.	Pabegat.
Pabrika.	Pabrika.
Pagkain.	Pagkaen.
Pagador.	Pagador.
Pagkain.	Pagkaen.
Palakol.	Parakol.
Palasyo.	Palasio.
Pamilya.	Pamilia.
Paminta.	Piminta.
Pangako.	Pangako.
Parilya.	Parilia.
Patawad.	Patawad.
Patuwad.	Patowad.
Pawikan.	Pawikan.
Pebrero.	Pibriro.
Pinggan.	Pinggan.
Pintura.	Pintora.
Piyansa.	Piyansa.
Planeta.	Planita.
Plastik.	Plastik.
Posporo.	Posporo.
Propeta.	Propita.
Puhunan.	Pohonan.
Pulgada.	Polgada.
Pulpito.	Polpito.
Putakti.	Kotapdi.
Reklamo.	Riklamo.
Repolyo.	Ripolyo.
Reporma.	Riporma.
Resulta.	Risolta.
Rimatse.	Rimatsi.
Riserba.	Risirba.
Romansa.	Romansa.
Rosaryo.	Rosaryo.
Salamat.	Salamat.
Salamin.	Salamin.
Sapatos.	Sapatos.
Sekreta.	Sikrita.
Semento.	Siminto.
Sibuyas.	Siboyas.
Silbato.	Sirbato.
Silong.	Silungan.
Sinelas.	Sinilas.
Sinelas.	Sinilas.
Singkit.	Singkit.
Sipilyo.	Sipilyo.
Sipunin.	Siponon.
Sistema.	Sistema.
Subasta.	Subasta.
Sugalan.	Sugalan.
Sugarol.	Sugarol.
Sumpong.	Sumpong.
Sundalo.	Sundalo.
Sundang.	Sundang.
Suwelas.	Suwelas.
Suweldo.	Suweldo.
Suwelte.	Suwelte.
Taginit.	Taginit.
Tagulan.	Tagulan.
Tandang.	Tandang.
Tanglad.	Tanglad.
Timbang.	Timbang.
Tinapay.	Tinapay.
Tindera.	Tindera.
Tinidor.	Tinidor.
Tinidor.	Tinidor.
Trabaho.	Trabaho.
Tropedo.	Tropedo.
Turumpo.	Turumpo.
Tuwalya.	Tuwalya.
Martes.		Martis.
Sabado.		Sabado.
Agosto.		Agosto.
Huwebes.	Hoibis.
Kulog.	Dalegdeg.
Wala.	Ara.
Anim.	Anem.
Anim.	Sais.
Walo.	Walo.
Walo.		Otso.
Ano Pa?		Ano Pa?.
Maanghang.	Maarat.
Alitaptap.	Panget.
Bubuyog.	Pokyotan.
Garapata.	A Dotor.
Paminta.	Katombal.
Hinlalaki.	Inaina.
Tahimik.	Silinsio.
Gwapo.	Goapo.
Magdagdag.	Dogang.
Kumuha.	Bawi.
Kunin.	Bel.
Magising.	Magmata.
Apeliedo.	Apilido.
Kantiyaw.	Kantiao.
Kumpuni.	Komponir.
Dausdus.	Dalosdos.
Eroplan.	Iroplano.
Galyetas.	Galitas.
Gobyerno.	Gobirno.
Heneral.	Hiinirral.
Iling.	Ilengileng.
Maghapon.	Magapon.
Maalapad.	Malapad.
Nalaman.	Naelaman.
Nerbiyos.	Nirbyos.
Pabayaan.	Pabayan.
Pulisya.	Polisya.
Usisera.	Usiserah.
Usisero.	Usiseroh.
Linggo.	Domingo.
Pebrero.	Pibriro.
Biyernes.	Birnis.
Oktubre.	Oktobri.
Planeta.	Planita.
Ipo-Ipo.	Karatong.
Pito.	Pito.
Pito.	Syiti.
Salamat.	Salamat.
Sino Pa?	Sino Pa?.
Linggo.	Kada Adlaw.
Sa Gabi.	Kada Gabi.
Oras Ng Gabi.	Gabi.
Kakilala.	Kakilala.
Ubo.	Obo.	
Hawak.	Awid.
Hawak.	Kabeg.
Pumili.	Popo.
Pumili.	Pili.
Elepante.	Ilipanti.
Mangkopa.	Mangkopa.
Mansanas.	Mansanas.
Kalabasa.	Kalabasa.
Kangkong.	Kangkong.
Singkamas.	Tikamas.
Ay Mali!.	Ay Mali!.
Tahimik.	Mademen.
Maganda.	Mapostora.
Generoso.	Agataw.
Gastador.	Gastador.
Madaldal.	Malisang.
Maganda.	Mapostora.
Mas Bata.	Mas Bata.
Mas Luma.	Mas Loma.
Mas Bago.	Mas Bago.
Alketan.	Alkitran.
Alimango.	Alimango.
Alugbati.	Alogbati.
Aparador.	Apardaor.
Atrasado.	Atrasado.
Bakasyon.	Bakasio.
Bangkero.	Bankiro.
Bangketa.	Bankita.
Basabasa.	Basabasa.
Bastidor.	Bastidor.
Beterano.	Bitirano.
Bibingka.	Bibingka.
Kabataan.	Kabataan.
Kalabasa.	Kalabasa.
Kamandag.	Kamandag.
Kamiseta.	Kamisita.
Kampanya.	Kampania.
Kangkong.	Tangkong.
Kapritso.	Kapritso.
Karatula.	Karatola.
Kolehiyo.	Kolihiyo.
Kompanya.	Kompania.
Konsehal.	Konsihal.
Kontrata.	Kontrata.
Kriminal.	Kriminal.
Kudkuran.	Kodkodan.
Kulungan.	Kolongan.
Kumbento.	Kombinto.
Kumpisal.	Kompisar.
Kutsilyo.	Kotsilio.
Kutsinta.	Kotsinta.
Kuwerdas.	Kowirdas.
Kuwintas.	Kolintas.
Dahandahan.	Dandan.
Delikado.	Dilikado.
Dentista.	Dintista.
Deposito.	Diposito.
Dingding.	Dingding.
Dumalaga.	Domaraga.
Eklipse.	Ingklipsi.
Ehersisyo.	Irsisio.
Elepante.	Ilipanti.
Engkanto.	Inkanto.
Eskuwala.	Iskowala.
Eskuwela.	Iskowila.
Espiritu.	Ispiritu.
Espongha.	Ispongha.
Estasyon.	Istasion.
Estatuwa.	Istatowa.
Galapong.	Galapong.
Gastador.	Gastador.
Gilingan.	Gilingan.
Gumamela.	Gomamila.
Guwantes.	Gowantis.
Guyabano.	Goyabano.
Hustisya.	Hostisya.
Insiyenso.	Insinsi.
Labatiba.	Labatiba.
Libingan.	Lebengan.
Magasawa.	Magasawa.
Malagkit.	Maragket.
Malasado.	Malasado.
Manugang.	Manogang.
Martilyo.	Martilio.
Masinsin.	Masensen.
Mayabong.	Marabong.
Mekaniko.	Mikaniko.
Mikrobyo.	Mikrobyo.
Minindal.	Mirindal.
Ngisngis.	Ngisngis.
Orihinal.	Orihinal.
Pakimkim.	Pakemkem.
Pagkatao.	Pagkatao.
Palaspas.	Palaspas.
Palengke.	Palingki.
Palikpik.	Palikpik.
Palupalo.	Palopalo.
Panadero.	Panadiro.
Panganay.	Panganay.
Panggabi.	Panggabi.
Pantalan.	Pantalan.
Pasahero.	Pasahiro.
Pelikula.	Pilikola.
Pingpong.	Pingpong.
Prinsipe.	Prinsipi.
Prinsesa.	Prinsisa.
Pukyutan.	Potyokan.
Pulitika.	Politika.
Pulitiko.	Politiko.
Puntirya.	Pontirya.
Rebolber.	Ribolber.
Relasyon.	Rilasyon.
Repinado.	Ripinado.
Salubsob.	Salogsog.
Sarisari.	Sarisari.
Sibilyan.	Sibilian.
Sinangag.	Sinanlag.
Singkamas.	Tikamas.
Singsing.	Singsing.
Sinturon.	Sintoron.
Sorbetes.	Sorbetes.
Sustento.	Sustento.
Tanikala.	Tanikala.
Telepono.	Telepono.
Tenyente.	Tenyente.
Tindahan.	Tindahan.
Tiyangge.	Tiyangge.
Tonelada.	Tonelada.
Tsinelas.	Tsinelas.
Tungtong.	Tungtong.
Tag-Init.	Tag-Init.
Eklipse.	Bakonawa.
Langit.	De Langit.
Dalawa.	Darwa.
Dalawa.	Dos.
Tatlo.	Tatlo.
Tatlo.	Tris.
Apat.	Apat.
Apat.	Koatro.
Lima.	Lima.
Lima.	Singko.
Siyam.	Siam.
Siyam.	Noibi.
Oras ng araw.	Adlaw.
Mamaya.	Lagat-Lagat.
Yakap.	Akes.
Yakap.	Kepkep.
Sipang.	Sikad.
Sipang.	Sipa.
Makipag-Usap.	Limeg.
Salaginto.	Bagangan.
Kabote.	Kolat-Kolat.
Kamag-Anak.	Parinti.
Kilay.	Kelai.
Kilay.	Kelay.
Pilikmata.	Amimirek.
Malupit.	Mapintas.
Bawasan.	Awas.
Bawasan.	Boin.
Matulog.	Magkatorog.
Mas Mahal.	Mas Maal.
Alkansiya.	Alkansia.
Kaarawan.	Kaadlawan.
Kubyertos.	Korbitos.
Disyembre.	Disimbri.
Diyanitor.	Dianitor.
Epidemiya.	Ipidemia.
Ganansiya.	Ganansia.
Gantsilyo.	Gansilio.
Halimbawa.	Alimbawa.
Lisensiya.	Lisinsia.
Malinamnam.	Mananam.
Miyerkules.	Mirkoli.
Silangan.	Sidlangan.
Uniporme.	Unipormeh.
Gabi-Gabi.	Gabi-Gabi.
Gitna.	Tenga.
Gitna.	Sintro.
Harap.	Onan.
Harap.	Sa Onan.
Likod.	Likod.
Likod.	Sa Ori.
Asim.	Aslem.
Asim.	Maaslem.
Mapait.	Pait.
Mapait.	Mapait.
Umiyak.	Tangis.
Umiyak.	Iwik.
Uminom.	Inem.
Uminom.	Laklak.
Ihagis.	Pilak.
Ihagis.	Rabon.
Huwag.	Te’lek.
Huwag.	Kabli.
Latigo.	Palo.
Latigo.	Lapdes.
Ulo Ng Lupa.	Ololago.
Sampaloc.	Kalampisaw.
Camansi.	Kolo.
Camansi.	Rimas.
Baba Ng Panga.	Timid.
Balakang.	Balikawang.
Binti.	Batis.
Talampakan.	Raparapa.
Mapagmataas.	Ambogon.
Mapagmataas.	Maambog.
Malupit.	Ara Kanogon.
Buksan.	Abirto.
Buksan.	Abrian.
Bukas.	Abri.
Maghiwalay.	Magbelag.
Albularyo.	Albolario.
Arawaraw.	Adlawadlaw.
Badminton.	Badminton.
Basketbol.	Baskitbol.
Brilyante.	Brilianti.
Kamantige.	Kamantigi.
Kamatayan.	Kamatayan.
Kandidato.	Kandidato.
Karetilya.	Garatilia.
Kasalanan.	Kasalanan.
Kasulutan.	Kasolatan.
Katapusan.	Kataposan.
Kuwadrado.	Kowadrado.
Eleksiyon.	Iliksiyon.
Entablado.	Intablado.
Eskandalo.	Iskandalo.
Makinista.	Makinista.
Magaspang.	Magaspang.
Malunggay.	Balonggay.
Matrikula.	Matrikola.
Munisipyo.	Monisipyo.
Ngudngud.	Nfeyengete.
Pambihira.	Pambihira.
Panaderya.	Panadiry.
Prinsipal.	Prinsipal.
Prusisyon.	Prosisyon.
Relihiyon.	Rilihiyon.
Republika.	Ripoblika.
Salbabida.	Salbabida.
Sertipiko.	Sirtipiko.
Sigarilyo.	Sigarilyo.
Talakitok.	Talakitok.
Tarantado.	Tarantado.
Telegrama.	Telegrama.
Timbangan.	Timbangan.
Traysikil.	Traysikil.
Nobyembre.	Nobimbri.
Disyembre.	Disimbri.
Bahaghari.	Balangaw.
Sampu.	Sampolo.
Sampu.	Dyis.
Pakiusap!	Patigayon!
Isang Piso.	Saka Piso.
Ligtas.	Bonggo.
Ligtas.	Tolod.
Sumigaw.	Ogiaw.
Sumigaw.	Erang.
Sumisip.	Silig.
Sumisip.	Karas.
Bumbilya.	Boyog-Boyog.
Paruparo.	Alibangbang.
Alimango.	Tebed-Tebed.
Sinigwelas.	Sirgoilas.
Ano kaya?	Ano kabay?
Tanga.	Maroya ag isip.
Mapagmataas.	Bogalen.
Maliit.	Maite.
Maliit.	Maitey.
Mababa.	Mababa.
Mababa.	Potot.
Pababa.	Baba.
Pababa.	Paibaba.
Ebidensiya.	Ibidinsia.
Makinilya.	Makinailya.
Mantikilya.	Matikilya.
Monumento.	Maniominto.
Palanggana.	Planggana.
Punongkahoy.	Ponokaoy.
Purgatoryo.	Porgatory.
Sampaguita.	Sampagita.
Tag-Ulan.	Tag-Ororan.
Bulalakaw.	Bolalakaw.
Isang libo.	Saka ribo.
Araw-araw.	Adlaw-adlaw.
Hatinggabi.	Tenga gabi.
Sa ngayon.	Dading lagi.
Tuwing hapon.	Kadaapon.
Isang taon.	Saka dagon.
Umusad.	Dayon.
Umusad.	Dalagan.
Tanggap.	Risibi.
Tanggap.	Dawat.
Pukol.	Sontok.
Pukol.	Pabotil.
Tumawa.	Alakak.
Tumawa.	Kadlaw.
Hugasan.	Bonak.
Hugasan.	Koskos.
Sigarilyas.	Sigidilias.
Bulbol ng pubis.	Sabot.
Ay sayang!	Ay sayang!
Hilain.	Beteng.
Hilain.	Be’ras.
Sa taas.	Sa obong.
Pataas.	Pasaka.
Mas malaki.	Mas mabael.
Mas maliit.	Mas maitey.
Mas mataas.	Mas mataas.
Mas mababa.	Mas mababa.
Mas mataas.	Mas mataas.
Mas mababa.	Mas mababa.
Mas pangit.	Mas marimo.
Mas malaki.	Mas marake.
Mas maliit.	Mas maitey.
Mas mahina.	Mas maroya.
Mas magaan.	Mas maagan.
Mas murang.	Mas barato.
Mas matanda.	Mas malam.
Alang-alang.	Alang-alang.
Bentilador.		Bilintador.
Bungisngis.	Bongisngis.
Kampanaryo.	Kampanaryo.
Demokrasya.	Dimokrasia.
Ebanghelyo.	Ibanghilio.
Engkantado.	Ingkantado.
Eskuwelahan.	Iskowilan.
Estudyante.	Istodianti.
Galunggong.	Galonggong.
Gobernador.	Gobirnador.
Milyonaryo.	Milyonaryo.
Pakinabang.	Pakinabang.
Pagkatapos.	Pagkatapos.
Salamangka.	Salamangka.
Sekretarya.	Sikritarya.
Sinegwelas.	Sirgoilas.
Sinegwelas.	Sirgoilas.
Sustansiya.	Sustansiya.
Watakwatak.	Watakwatak.
Miyerkules.	Mirkolis.
Kumusta?	Komosta kamo?
Kagabi.	Kaapon nga gabi.
Isang buwan.	Saka bolan.
Magkano?	Pira?
Magkano?	Tagpira?
Huminto.	Tadeng.
Huminto.	Panari.
Matamis.	Tamis.
Matamis.	Matamis.
Tumakbo.	Dalagan.
Tumakbo.	Keras.
Maglakad.	Panaw.
Maglakad.	Tikang.
Langaw.	Langaw.
Langaw.	Agindan.
Labanos.	Rabanos.
Labanos.	Radis.
Para saan?	Para sadin?
Gwapo.	Matinlong lalaki.
Malaki.	Mabael.
Malaki.	Malapad.
Itago.	Tagon.
Itago.	Palipedan.
Mas mahaba.	Mas malabeg.
Mas maikli.	Mas mataged.
Mas mabagal.	Mas maloyo.
Mas makitid.	Mas mapiet.
Bato-balani.	Batobalani.
Estranghero.	Istranhiro.
Heringgilya.	Iringgilia.
Setyembre.	Siptimbri.
Maya maya.	Lagat-lagat.
Talaga ba?	Matod manda?
Nasa sa iyo.	Baala kaw.
Masamang panaginip.	Opay.
Sampung piso.	Dyis pisos.
Babaeng manok.	Manigbata.
Gering-giring.	Dalomasig.
Kapatid na babae.	Manang.
Pamangkin.	Inables nga babai.
Apong babae.	Apong babai.
Ulo at leeg.	Olo ig lieg.
Likod ng tuhod.	Lele’nan.
Ano kung?	Samaoro kong?
Kawawa naman!	Kailo ra!
Matipid.	Matipid.
Matipid.	Maimet.
Generoso.	Abri ang alima.
Mas mabilis.	Mas madasig.
Mas makapal.	Mas madamel.
Mas manipis.	Mas manipis.
Mas mabigat.	Mas mabeagat.
Mas matigas.	Mas mategas.
Mas malalim.	Mas madalem.
Mas mababaw.	Mas mababaw.
Mas madumi.	Mas maboring.
Kasangkapan.	Kasangkapan.
Korporasyon.	Korporasyon.
Konsumisyon.	Konsimision.
Inspirasyon.	Inspirasyon.
Araw-araw.	Adlaw-adlaw.
Araw-araw.	Tanang adlaw.
Magkano?	Pira?
Magkano?	Tagpira?
Alog.	Ileng-ileng.
Alog.	Dogdog.
Pamilya.	Pamilia.
Kapatid na lalaki.	Manong.
Bukong-bukong.	Pokolpokol.
Walang ingat.	Aras-aras.
Mas malakas.	Mas mabaskeg.
Mas malapad.	Mas mawayang.
Mas malambot.	Mas malemek.
Mas malinis.	Mas malimpio.
Limang libo.	Lima ka ribo.
Isang linggo.	Saka domingo.
Limang piso.	Lima ka pisos.
Lalaki ng manok.	Langganen.
Nephew.	Inables nga lalaki.
Apong lalaki.	Apong lalaki.
Takip mata.	Kilid ang mata.
Bakit ganyan?	Ayamo dato?
Mabuhay.	Maboi.
Mabuhay.	Magpakaboi.
Anting-anting.	Anting-anting.
Salamangker.	Salamangkiro.
Apat na libo.	Apat ka ribo.
Araw at gabi.	Adlaw ig gabi.
Liwanag ng araw.	Pagkasanag.
Tuwing umaga.	Kada timprano.
Pagbabago ng pera.	Sinsilio.
Isang sentimo.	Saka sintabo.
Dalhin.	Dara.
Dalhin.	Bitbit.
Dalhin.	Karga.
Ikiling.	Tonga.
Ikiling.	Tonga-tonga.
Paniki.	Kabilaw.
Paniki.	Kolala’nit.
Anak na babae.	Batang babai.
Buong mukha.	Itsora.
Mapagpakumbaba.	Mababa leba.
Ipakita.	Ipaseleng.
Kamotengkahoy.	Kamotengkaoy.
Pitumpu.	Pitompolo.
Pitumpu.	Sitinta.
Walumpu.	Walompolo.
Walumpu.	Otsinta.
Tatlong libo.	Tatlo ka ribo.
Bukang-liwayway.	Kasasanagen.
Asawang babae.	Asawang babai.
Unang pinsan.	Ilog i kaisara.
Kuko sa kamay.	Koko sa alima.
Kuko ng daliri.	Koko sa siki.
Walang ingat.	Ara pag amblig.
Mahirap.	Malised.
Mahirap.	Ara koarta.
Pinakamabenta.	Pinakabaminta.
Dalawang libo.	Darwa ka ribo.
Bukas ng gabi.	Aroman sa gabi.
Sa ibang araw.	Sa ibang adlaw.
Napakamahal!	Masiadong maal!
Anak na lalaki.	Batang lalaki.
Bakit mahirap?	Ayamo makori?
Magtanggap.	Magtogot.
Magtanggap.	Togotan.
Bagyo.	Mabaskeg nga karatong.
Dalawampu.	Darwampolo.
Dalawampu.	Bainti.
Tatlumpu.	Tatlompolo.
Tatlumpu.	Trainta.
Isang daan.	Saka gatos.
Isang daan.	Sinto.
Ngayon.	Dadi.
Ngayon.	Sa adlaw nga dia.
Bukas ng hapon.	Aroman sa apon.
Maghapon.	Magaapon.
Maghapon.	Saka adlaw.
Magdamag.	Magdamlag.
Dalawampung piso.	Bainti pisos.
Ang pulang ito.	Ang mapola.
Ang puting ito.	Ang mapoti.
Gusto ko ito.	Aliagan ko dia.
Siya si Alice.	Tana si Alice.
Asawang lalaki.	Asawang lalaki.
Ikalawang pinsan.	Ilog i karwa.
Ninang ng sariling anak.	Komay.
Kasukasuan.	Kaogatan.
Kasukasuan.	Tornilio.
Saan ka na?	Adin kaw agpakon?
Generoso.	Madali i pakitawan.
Mamatay.	Mapatay.
Limampu.	Limampolo.
Limampu.	Singkointa.
Hanggang sa muli.	Dading lagi.
Sa ibang araw.	Sa pira ka adlaw.
Kuwartang papel.	Koartang papil.
Suhol na pera.	Padanleg.
Puso ng saging.	Poso ang saging.
Ninong ng sariling anak.	Kompay.
Sino ka?	Sino kaw?
Sino ka?	Ikaw sino?
Saan ka galing?	Tagasadin kaw?
Pangit.	Marimo.
Pangit.	Beken i postora.
Magalit.	Masalug.
Magalit.	Magpangasilag.
Kamotengbaging.	Kamottingbalagen.
Magandang gabi.	Mayad nga gabi.
Paalam!	Adios! Maalin ako ron!
Sa makalawa.	Sa pangarwang adlaw.
Limampung piso.	Singkointa pisos.
Ang maliit na ito.	Ang maite.
Ang nasa gitna.	Ang sa tenga.
Gusto ko iyon.	Aliagan ko dato.
Mag-ingat.	Pag-amdam.
Mag-ingat.	Pag-amblig.
Masama.	Marimo.
Masama.	Bastos ang ogali.
Animnapu.	Anem ka polo.
Animnapu.	Saisinta.
Siyamnapu.	Siam ka polo.
Siyamnapu.	Nobinta.
Magandang araw.	Mayad nga adlaw.
Magandang hapon.	Mayad nga apon.
Nag-aalangan ako.	Alanganen ako.
Kahapon ng hapon.	Kaapon nga apon.
Guni-guni ng araw.	Akatonganga.
Malamig na gabi.	Maramig nga gabi.
Bago ba ito?	Bago pa dia?
Ang itim na ito.	Ang mangitit.
Tumulong.	Tabid.
Tumulong.	Tabiden.
Tumulong.	Tabidan.
Anak na babae.	Ing anak nga babai.
Ayan ang lalaki!	Dan ang lalaki!
Bakit dapat gawin?	Ayamo simpri!
Mayaman.	Manggaden.
Mayaman.	Dorong koarta.
Magkasama.	Mag imbeng.
Magkasama.	Magtabidan.
Labinlima.	Sampolo ig lima.
Labinlima.	Kinsi.
Apatnapu.	Apat nga polo.
Apatnapu.	Koarinta.
Pasok!	Pagdayon kamo.
Pasok!	Dayon kamo.
Mabuti, salamat.	Mayada, salamat.
Bukas ng umaga.	Aroman sa timprano.
Maagang gabi.	Bago mag gabi.
Maagang gabi.	Sirem.
Mahilig sa pera.	Matakab sa koarta.
Bago ba ito?	Dia bago?
Bago ba ito?	Bago dia?
Ang malaki na ito.	Ang mataged.
Ang mahaba na ito.	Ang malabeg.
Malapit.	Masebek.
Marapit.	Masebek.
Mapait.	Mapaet.
Talbos ng kamote.	Ogbos ang kamoti.
Bakit ka galit?	Ayamo asilag kaw?
Bakit ka nandito?	Ayamo digi kaw?
Matalino.	Braít.
Matalino.	Maantigo.
Matalino.	Akaelam.
Pinong tao.	Pino.
Pinong tao.	Beken i maraskal.
Tumanggi.	Indi agtogot.
Tumanggi.	Pangindian.
Pagkukumpra.	Pagkompara, pagtakes.
Mas maganda.	Mas matinlo.
Labing-isa.	Sampolo ig isara.
Labing-isa.	Onsi.
Palit ng pera.	Taga bailo i’ koarta.
Magkano ito?	Pira dia.
Magkano ito?	Tagpira dia.
Bibili ako nito.	Babakalen ko dia.
Biyenan na babae.	Panogangang babai.
Anak na lalaki.	Ing anak nga lalaki.
Saan ka pupunta?	Adin kaw mapakon?
Labindalawa.	Sampolo ig darwa.
Labindalawa.	Dosi.
Labintatlo.	Sampolo ig tatlo.
Labintatlo.	Trisi.
Maraming salamat.	Matamang salamat.
Sa mga araw na ito.	Sa pira ka adlaw.
Isang daan piso.	Saka gatos ka pisos.
Maging alerto.	Alisto kaw.
Maging alerto.	Pagbantay.
Maging malungkot.	Mapongaw.
Maging malungkot.	Pongawan.
Limang daan.	Lima ka gatos.
Limang daan.	Kinintos.
Magandang umaga.	Mayad nga timprano.
Kahapon ng umaga.	Kaapon nga timprano.
Isang araw.	Isarang adlaw.
Isang araw.	Saka adlaw.
Alkansya.	Alkansia.
Alkansya.	Taragoan i koarta.
Bago ba iyon?	Dato bago?
Bago ba iyon?	Bago dato?
Ang nasa likod.	Dato ang sa likod.
Bibili ako niyan.	Babakalen ko dato.
Maghintay sa kanto.	Pag elat sa kanto.
Biyenan na lalaki.	Panogangang lalaki.
Manugang na babae.	Manogang nga babai.
Ano ang pangalan mo?	Ano imong aran?
Kailan ka umalis?	Kaano kaw agpakon?
Saan siya galing?	Adin tana ag alin?
Bakit ka masaya?	Ayamo maambeng kaw?
Bakit mahirap?	Ayamo makori?
Maging masaya.	Malipay.
Maging masaya.	Magpangalipay.
Magsinungaling.	Magbotig.
Magsinungaling.	Kon i botig.
Labing-apat.	Sampolo ig apat.
Labing-apat.	Katorsi.
Labimpito.	Sampolo ig pito.
Labimpito.	Disisyiti.
Labingwalo.	Sampolo ig walo.
Labingwalo.	Disiotso.
Huwag naman sana!	Patawaden ang Gino!
Guni-guni ng araw.	Agaisip i’ madalem.
Limampung sentimo.	Singkointa sintabos.
Magkano iyan?	Pira dato.
Magkano iyan?	Tagpira dato.
Liko sa kanan.	Liko sa to.
Liko sa kanan.	Teyeb sa to.
Matamis ang kendi.	Matamis ang kindi.
Maasim ang suka.	Maaslem ang langgaw.
Dahon ng malunggay.	Daon ang balonggay.
Sino ang gobernador?	Ang gobernador?
Taga saan po kayo?	Taga adin kamo?
Labing-anim.	Sampolo ig anem.
Labing-anim.	Disisais.
Labinsiyam.	Sampolo ig siam.
Labinsiyam.	Disinoibi.
Walang anuman.	Indi moy intindien dan.
Ganoon ba?	Dato gali?
Ganoon ba?	Kondato talaga?
Darating ang araw.	Magaabot ang adlaw.
Noong nakaraang taon.	Aglebas nga dagon.
Maraming pera.	Dorong koarta.
Maraming pera.	Manggaden.
Manugang na lalaki.	Manogang nga lalaki.
Sino ang kasama mo?	Sino imong kaiban?
Kailan ka dumating?	Kaano kaw ag abot?
Kailan ka darating?	Inoro kaw mapakon?
Kailan tayo kakain?	Inoro kita makaen?
Saan mo nakuha iyon?	Adin mo abel dan?
Bakit ka umiiyak?	Ayamo agatangis kaw?
Ilang taon ka na?	Pira ka ren kadagon?
Ano ang trabaho mo?	Ano imong trabaho?
Walong daan.	Otso sintos.  
Sampung libo.	Sampolo ka ribo.  
Tuwing isang araw.	Kada darwa ka adlaw.  
Hanggang ngayon.	Asta sa adlaw nga dia.  
Sa susunod na araw.	Sa madason nga adlaw.  
Sa susunod na taon.	Sa madason nga dagon.  
Noong nakaraang buwan.	Aglebas nga bolan.  
Ang nakalagay dito.	Ang dato sa onan.  
Mag-ingat!	Amblig!  
Mag-ingat!	Bantay!  
Mag-ingat!	Pagbantay!  
Kailangan kong nandito.	Dapat doto ako.  
Ano ang masasabi mo?	Ano imong kakokon?  
Kailan ito nangyari?	Kaano dato atabo’?  
Bakit ka tumatawa?	Ayamo agakadlaw kaw?  
Bakit ka malungkot?	Ayamo mapongaw kaw?  
Bakit ka sumisigaw?	Ayamo agaogiaw kaw?  
Ano po ang sa atin?	Ano ang kanaten?  
Maupo muna kayo.	Pagurang kamo anay.  
Anim na raan.	Anem ka gatos.  
Anim na raan.	Sais sintos.  
Pitong daan.	Pito ka gatos.  
Pitong daan.	Syiti sintos.  
Bukas ng tanghali.	Aroman sa ogtong adlaw.  
Sa susunod na araw.	Sa madason nga adlaw.  
Sa susunod na buwan.	Sa madason nga bolan.  
Ano sa tingin mo?	Ano sa imong pabetang?  
Dalawang daan.	Darwa ka gatos.  
Dalawang daan.	Dos sintos.  
Tatlong daan.	Tatlo ka gatos.  
Tatlong daan.	Tris sintos.  
Mamayang gabi.	Lagat sa gabi.  
Mamayang gabi.	Dadi sa gabi.  
Mga taon na lumipas.	Aglebas nga mga dagon.  
Nagpapahiram ng pera.	Agapaotang i koarta.  
Mapait ang ampalaya.	Mapait ang maragoso.  
Bakit kita mahal?	Ayamo ingmamaal ta kaw?  
Bakit gusto kita?	Ayamo aliliagan ta kaw?  
Maantigo.	Brait tana.  
Ikaw ay kaakit-akit.	Matinlong lalaki kaw.  
Apat na raan.	Apat ka gatos.  
Apat na raan.	Koatro sintos.  
Siyam na raan.	Siam ka gatos.  
Siyam na raan.	Noibi sintos.  
Noong nakaraang Linggo.	Aglebas nga Domingo.  
Luma ba ito?	Dia loma ren?  
Luma ba ito?	Dia malam den?  
Liko sa kaliwa.	Liko sa wala.  
Liko sa kaliwa.	Teyeb sa wala.  
Ano ang gagawin natin?	Ano ateng boboaten?  
Bakit ka natatakot?	Ayamo ing adlekan kaw?  
Bakit ka nanginginig?	Ayamo agakelkeg kaw?  
Bakit, ikaw ang dahilan!	Ayamo, ikaw dato!  
Ikaw ay matalino.	Maantigo kaw.  
Ikaw ay matalino.	Brait kaw.  
Siya ay matalino.	Maantigo dan.  
Siya ay matalino.	Brait dan.  
Ikaw ay mapagpakumbaba.	Mababa imong leba.  
Pinakamaganda.	Pinakamaantigo.  
Pinakamaganda.	Pinakamaosay.  
Sino ang city mayor?	Sino ang city mayor?  
Pakihintay lang po.	Patigayon y elaten.  
Magandang tanghali.	Mayad nga ogtong adlaw.  
Patawad.	Pasinsia lamang.  
Patawad.	Pakitaw pasinsia.  
Nagtataka ako, bakit?	Abebereng ako, ayamo?  
Kahapon ng tanghali.	Kaapon nga ogtong adlaw.  
Sa liwanag ng araw.	Sa kasasanagen ang adlaw.  
Sa susunod na linggo.	Sa madason nga domingo.  
Sa susunod na Linggo.	Sa madason nga Domingo.  
Lugar para sa paradahan.	Paradan.  
Lugar para sa paradahan.	Taradengan.  
Maanghang ang paminta.	Maarat ang katombal.  
Ang pangalan niya ay Mark.	Mark anang aran.  
Siya ay taga Bulacan.	Tana ay taga Bulakan.  
Isang milyon.	Isara ka million, saka million.  
Maligayang pagdating!	Maambeng nga pag-abot!  
Pagpalain ka ng Diyos!	Kaloyan kaw ang Dios!  
Araw bago ngayon.	Bago pa ang adlaw nga dia.  
Noong nakaraang gabi.	Gabi bago kaapon.  
Sino ang kaibigan mo?	Sino dan imong tangay?  
Kailan mangyayari iyon?	Inoro dato matatabo?  
Bakit ka nagtago?	Ayamo agatago kaw?  
Ang pangalan ko ay Mark.	Akeng aran ay Mark.  
Ako ang bahala.	Ako ang baala.  
Ako ang bahala.	Baala ako ron.  
Napakamahal!	Ang maal ingan!  
Napakamahal!	Masiadong maal!  
Luma ba iyon?	Loma ren dato?  
Luma ba iyon?	Malam den dato?  
Ano ang dapat kong gawin?	Ano akeng boboaten?  
Kailan ka pupunta?	Inoro kaw mapakon?  
Bakit hindi mo sabihin?	Ayamo animan ngani.
Makasarili.	Isbotan.  
Makasarili.	Maisbot.  
Makasarili.	Sirado ang alima.
Maging magkaibigan.	Magpakigtangay.
Maging magkaibigan.		 Paratangay.
Kahit ano pa ang mangyari.	Maski anong matabo.
Bawal ang parada.	Bawal agparada.
Bawal ang parada.	Indi agparada.
Saan mo ito ginagamit?	Sadin mo dan gagamiten?
Siya ay maganda.	Mapostora tana.
Siya ay maganda.	Matinlo tana.
Tana ang pinakamahusay.	Tana ang pinakamaosay.
Isang daang libo.	Saka gatos ka ribo, sinto mil.
Isang Libong Piso.	Saka ribo ka pisos.
Isang Libong Piso.	Saka ribo.
Sino ang nagsabi sa iyo?	Sino ang agkon kanimo?
Sa tulong ng Diyos!	Kong itogot ang Gino!
Ako ang bahala sa sitwasyon.	Ako ang baala dian.
Gabing nagdaan.	Kaapon nga gabi.
Gabing nagdaan.	Aglebas nga gabi.
Mataas ang presyo.	Ang taas ang prisio.
Mataas ang presyo.	Ang maal.
Kailan ka pupunta sa bahay?	Inoro kaw mapakon sa balay?
Bakit ako dapat mag-alala?	Ayamo magadoadoa ako?
Dalawampung libo.	Darawampolo ka ribo, bainti mil.
Kamakalawa.	Aglebas nga darwa ka adlaw.
Kamakalawa.	Kasangapon.
Limang Daan Piso.	Lima ka gatos ka pisos.
Limang Daan Piso.	Kinintos.
Napakamura!	Ang kabarato ingan!
Napakamura!	Dorong kabarato!
Ano ang ibig mong sabihin?	Ano imong maliag ikon?
Siya ay mabuti.	Mayad tana.
Siya ay mabuti.	Mayad ang batang dia.
Sa inyo na lang ang sukli.	Kanimo ron ang sinsilio.
Pakibilan ako ng kape.	Patigayon pabakal ako kape.
Sino ang makikita natin?	Sino ang mabagat kanaten?
Dalawampu’t lima.	Darwampolo ig lima.
Dalawampu’t lima.	Bainti singko.
Pwede bang tumawad?	Poidi ka tawad.
Pwede bang tumawad?	Poiding tawadan.
Bakit ka nandito?	Ayamo digi kaw?
Bakit ka nandito?	Ayamo ikaw digi?
Bakit mo ito kailangan?	Ayamo kaministiran mo dato?
Saan ka mananatili dito?	Sadin kamo magadayon digi?
Paano kita matutulungan?	Samuro takaw matabangan?
Ano po ang inyong problema?	Ano indong problema?
Siya ay taga Cuyo, Palawan.	Taga Cuyo, Palawan tana.
Bakit ko ikinagagalit ka?	Ayamo asisilag ako kanimo?
Ang batang iyon ay maingat.	Maandam ang batang dato.
Ano po ang aming maitutulong?	Ano ameng katatabang?
Limang Libong Piso.	Lima ka ribong pisos.
Limang Libong Piso.	Lima ka ribo.
Maasin ang tubig sa dagat.	Maasin ang tobig sa dagat.
Ano ang maiaalok ko sa iyo?	Ano akeng katatao kanimo?
Isang daan at sampu.	Saka gatos ig sampolo
Isang daan at sampu.		 Sinto dyis
Paumanhin.	Poidi kalebas
Paumanhin.		 Poidi kaagi
Paumanhin.		 Palebas
Paumanhin.		 Paagi.
Huwag pahintulutan ng Langit!	Indi ra itogot ang Gino!
Bawal ang pagsakay at pagbaba.	Indi agsakay ig agbaba.
Kailan ka nanood ng pelikula?	Kaano kaw agseleng sini?
Kailan ka pumunta sa bahay?	Kaano kaw agpakon sa balay?
Saan ka nakatira?	Adin kaw agaistar?
Saan ka nakatira?	Adin kaw agaoli?
Bakit ka nag-uusisa?	Ayamo aga pangotana kaw?
Hindi ko alam kung bakit?	Indi ko maelaman kong ayamo?
Siya ay masipag.	Maderep tana.
Siya ay masipag.	Maderep ang batang dia.
Pahintulot ng Diyos.	Itogot ang Gino.
Pahintulot ng Diyos.	Togotan ang Gino.
Huminto, Tumingin at Makinig!	Tadeng, Seleng ig Pamati!
Sino ang mga magulang mo?	Sino imong mga gorang-gorang?
Sino ang nag-imbita sa iyo?	Sino ang ag imbitar kanimo?
Magsabi ng katotohanan.	Magbaeg ang Matod.
Magsabi ng katotohanan.	Kon ang Matod.
Ano po ang inyong kailangan?	Ano indong kaministeran?
Ibigay ang sukli.	Itaw ang sinsilio.
Ibigay ang sukli.	Sinsilioan mo.
Maglakad nang mabilisan.	Panaw i madasig.
Maglakad nang mabilisan.	Aporadong panaw.
Dalawang Libong Piso.	Darwa ka ribong pisos.
Dalawang Libong Piso.	Darwa ka ribo.
Maglakad nang mabilis.	Paspas ang panaw.
Maglakad nang mabilis.	Dasigan ang panaw.
Tumayo sa gitna ng kalsada.	Pagtindeg sa tenga ang karsada.
Magdahan-dahan.	Amat-amat lamang.
Magdahan-dahan.	Loay-loay lamang.
Magdahan-dahan.	Paloyo.
Mario, sasama ka ba sa amin?	Mario, ikaw matabid kanamen?
Saan ang masama sa pagsubok?	Ano ang marimo kong samitan?
Kailan ka dumating sa Puerto?	Kano kamo agabot sa Puerto?
Tama ang presyo.	Tama ang prisio.
Tama ang presyo.	Sakto lamang ang prisio.
Sino ang nagbigay sa iyo niyan?	Sino ang agtao kanimo dan?
Ano ang pangalan ng iyong pinsan?	Ano ang aran imong ilog?
Ang presyo ay mura.	Ang baba ang prisio.
Ang presyo ay mura.	Barato ang prisio.
Langgam.	Palamingko.
Anay.	Anay.
Langgam.	Dapo-dapo.
Langgam.	Dalit-dalit.
Langgam.	Koto-koto.
Ano ang maitutulong ko sa iyo?	Ano akeng katatabang kanimo.
Bakit ko ito sinabi sa iyo?	Ayamo ingkon ko dia kanimo.
Sampung Libong Piso.	Sampolo ka ribong pisos.
Sampung Libong Piso.	Sampolo ka ribo.
Isang daan at pitumpu.	Saka gatos ig pitompolo.
Isang daan at pitumpu.	Sinto sitinta.
Isang daan at walumpu.	Saka gatos ig walompolo.
Isang daan at walumpu.	Sinto otsinta.
Kung paano mo gusto.	Kong maliag kaw.
Kung paano mo gusto.	Kong ano imong aliagan.
Ito ang aking kaibigan.	Dagi akeng tangay.
Ito ang aking kaibigan.	Akeng tangay dia.
Gaano kalayo ang capitol mula dito?	Mororayeang capitol digi?
Maglakad nang dahan-dahan.	Loay-loay nga panaw.
Maglakad nang dahan-dahan.	Panaw i’ maloyo.
Isang daan at dalawampu.	Saka gatos ig darwampolo.
Isang daan at dalawampu.	Sinto bainti.
Isang daan at tatlumpu.	Saka gatos ig tatlompolo.
Isang daan at tatlumpu.	Sinto trainta.
Huwag mo nang intindihin.	Bayan mo ron lamang.
Huwag mo nang intindihin.	Indi moy isipen.
Sino ang sasama sa akin?	Sino ang matabid kanaken?
Ano po ang inyong pangalan, at edad po?	Ano imong aran, edad?
Isang daan at limampu.	Saka gatos ig limampolo.
Isang daan at limampu.	Sinto singkointa.
Kay ganda ng umaga!	Ang katinlo ingan ang timpo.
Wow, ang ganda!	Aroy, ang tinlo ingan!
Wow, ang ganda!	Aroy, ang katinlo baya!
Kailan mo natanggap ang aking text?	Kaano mo arisibi akeng tiks?
Ipapasyal namin siya sa siyudad.	Papasiar ta tana digi sa siodad.
Saan mo nakuha ang kuwentong iyon?	Adin mo abel ang kointong dan?
Isang daan at apatnapu.	Saka gatos ig apat ka polo.
Isang daan at apatnapu.	Sinto koarinta.
Isang daan at animnapu.	Saka gatos ig anem ka polo.
Isang daan at animnapu.	Sinto saisinta.
Isang daan at siyamnapu.	Saka gatos ig siam ka polo.
Isang daan at siyamnapu.	Sinto nobinta.
Huwag mo nang banggitin.	Ara bali dan.
Huwag mo nang banggitin.	Indi mo ron i sambiten dan.
Kailan mo sinabi na mahal mo ako?	Kaano kaw agkon nga maal mo ako?
Saan ang daan papunta sa city hall?	Sadin ang papakonsa city hall?
Isang Daan Libong Piso.	Sakagatos ka ribong pisos.
Isang Daan Libong Piso.	Saka gatos ka ribo.
Magandang Hapon, Kamusta po kayo?	Mayad nga apon, kumusta kamo ron?
Saan ka kumakain tuwing tanghali?	Adin kaw agakaen kada ogtong adlaw?
Ano ang pangalan ng iyong kapatid na babae?	Ano ang aran imong manang?
Isang Milyong Piso.	Isara ka miliong pisos.
Isang Milyong Piso.	Isara ka milion.
Isang Milyong Piso.	Saka milion.
Ano ang pangalan ng iyong kapatid na lalaki?	Ano ang aran imong manong.
Paki-fill up po ang form na ito.	Patigayon y sabaten ang form nga dya.
Gaano katagal ka mananatili sa Palawan?	Asta inoro kamo digi sa Palawan.
Ano ang mga magandang restawran dito?	Ano ang matitinlong karaenan digi?
Kilalanin mo ang kapatid kong lalaki.	Bagaten mo si manong.
Magandang Umaga, Kamusta po kayo?	Mayad nga timprano, kumusta kamo ron.
Magandang Tangahali, Kamusta po kayo?	Mayad nga ugto, kumusta kamo ron.
Ano ang pangalan ng mga magulang mo?	Ano ang aran imong mga gorang-gorang.
Mabuting mabuti, Salamat.	Mayad nga mayad, Salamat.
Mabuting mabuti, Salamat.	Dorong kaayad. Salamat.
Wow, ang tamis!	Aroy, ang tamis ingan!
Wow, ang tamis!	Aroy, midio papalamingkon den dan!
Narito siya para sumali sa Baragatan.	Digi tana para mag-ireg sa Baragatan.
Napakasaya ng oras na iyon!	Ang kaambeng kita noel.
Napakasaya ng oras na iyon!	Ang kaambeng kami ingan!
Pinakamahusay na manlalaro ng basketbol.	Pinakamaantigo agkarawat i baskitbol.
Magkano ang huling presyo?	Pira ang oring prisio.
Magkano ang huling presyo?	Pira ang pinakamababang prisio.
Huwag mag-iwan ng anumang gamit sa loob.	Indi magsala maski anong gamit sa seled.
Ang babaing iyon ay pinong tao.	Pino ang babaing dan.
Ang babaing iyon ay pinong tao.	Ang babaing dan ay matandes.
Ano ang pangalan ng iyong ama?	Ano ang aran i’ tatay mo?
Ano ang pangalan ng iyong ama?	Ano ang aran imong tatay?
Ano ang pangalan ng iyong ina?	Ano ang aran i’ nanay mo?
Ano ang pangalan ng iyong ina?	Ano ang aran imong nanay?
Huwag kang mawalan ng pag-asa.	Indi kaw madoran i' pagsarig.
Huwag kang mawalan ng pag-asa.	Indi agroya imong leba.
Ilang oras ang biyahe mula dito papunta sa bayan?	Pira ka oras ang biyahe papakon sa bayan?
Ano ang pangalan ng iyong nakababatang kapatid na babae?	Ano ang arat imong libayen nga babai?
Ano ang pangalan ng iyong nakababatang kapatid na lalaki?	Ano ang aran imong libayen nga lalaki?
Balik nalang po kayo bukas para mag-follow up.	Balik kamo ron lamang aruman para sa maelaman indo.
Ang malapit kong kaibigan ay darating mula sa Manila.	Akeng marapit nga tangay ay magaabot alin sa Manila.
Ano ang pangalan ng iyong nakatatandang kapatid na babae?	Ano ang aran imong manang? Ano ang aran i manang mo?
Ano ang pangalan ng iyong nakatatandang kapatid na lalaki?	Ano ang aran imong manong? Ano ang aran i manong mo?
Ano ang magagandang lugar na pwedeng bisitahin dito sa Puerto?	Anong matitinlong logar nga mapapakonan digi sa Puerto?
Nakatira siya sa Gomamela, Sta. Monica, Puerto Princesa City.	Aga istar tana sa Gomamila, Sta. Monica, Siodad i ang Puerto Princesa.